11111111111111
100C00000000P1
10000111111111
1000C000000001
1111111100C001
10000000000001
100C0111111111
1000C000C000E1
11111111111111
