11111111
100C0C01
10011001
1P011E02
11111111
