111111111
10P020CE1
111111111
