1111111111111
10010000000C1
1000011111101
1P0011E000101
1111111111111
