1111111111111
100C000C00001
1010111110101
1C100P0C001C1
1010111110101
1C100E0C001C1
1010111110101
100C000C00001
1111111111111
