1111111111
100010E001
10P0100001
10010C0001
100C000001
100C000001
1111111111
